<?xml version="1.0" encoding="UTF-8"?>
<level>
  <room backgroundId="0" size="1">
    <layer id="base">
      <data>14,28,29,29,17,17,17,17,17,17,17,17,17,17,17,17,17,17,17,17,17,17,17,17,17,17,17,30,14,14,14,27,0,0,0,0,0,0,0,0,0,0,0,13,16,17,17,17,17,17,17,17,17,17,17,17,17,17,17,17,17,17,17,17,17,29,29,29,29,29,29,29,29,29,29,30,26,26,26,26,26,26,26,26,26,26,26,28,29,29,29,17,17,17,17,17,
25,26,26,14,28,29,29,29,17,17,17,17,17,17,29,30,14,26,26,26,26,26,28,17,17,17,30,26,26,26,27,0,0,0,0,0,0,0,0,0,0,0,0,13,28,17,17,17,17,17,17,17,17,30,28,29,17,17,17,17,17,17,17,29,30,26,26,26,26,26,26,26,26,26,26,27,0,0,0,0,0,0,0,0,0,0,0,25,26,26,26,28,29,29,29,17,
0,0,0,25,14,14,14,14,28,29,29,29,29,30,14,14,15,0,0,0,0,0,25,28,29,30,15,0,0,0,0,0,0,0,0,0,0,0,0,0,0,0,0,25,26,28,29,17,17,17,17,17,18,14,14,4,17,17,17,17,17,17,30,26,27,0,0,0,0,0,0,0,0,0,0,0,0,0,0,0,0,0,0,0,0,0,0,0,0,0,0,0,0,0,25,28,
0,0,0,0,25,26,26,26,26,26,26,26,26,26,26,26,27,0,0,78,0,0,0,25,26,26,27,0,0,0,0,0,0,0,0,0,0,0,0,0,0,0,0,0,0,25,26,28,17,17,17,17,17,6,4,17,17,17,17,17,17,30,27,0,0,0,0,0,0,0,0,0,0,0,0,0,0,0,0,0,0,0,0,0,0,0,0,0,0,0,0,239,0,0,0,13,
0,0,0,0,0,0,0,0,0,0,0,0,0,0,0,0,0,0,0,0,0,0,0,0,0,0,0,0,0,0,0,0,0,0,0,0,0,0,0,0,0,0,0,0,0,0,0,13,29,17,17,17,17,17,17,17,17,17,17,17,30,27,0,0,0,0,0,0,0,0,0,0,0,0,0,0,0,0,34,0,0,0,116,118,0,0,0,0,118,0,102,103,0,73,22,13,
0,0,0,0,0,0,0,0,0,0,0,0,0,0,0,0,0,0,7,8,9,0,0,0,0,0,0,0,0,0,0,0,0,0,0,0,0,0,0,0,0,0,0,0,0,0,0,25,26,28,29,17,17,17,17,17,17,17,17,18,15,0,0,0,0,0,0,0,0,0,0,0,0,0,0,0,0,0,34,0,0,0,7,9,0,0,0,7,9,0,1,2,2,2,2,14,
0,0,0,0,0,0,0,0,0,0,0,0,0,0,0,0,0,0,0,0,0,0,0,0,0,0,0,0,0,0,0,0,0,0,0,0,0,0,0,0,0,0,0,0,0,0,0,0,0,25,26,28,29,29,17,17,17,17,17,18,15,0,0,0,0,0,0,0,0,0,0,0,0,34,0,0,0,0,0,0,0,0,0,34,0,0,0,0,34,0,25,26,26,26,26,26,
0,0,0,0,0,0,0,0,0,0,0,0,0,0,0,0,0,0,0,0,0,0,0,0,0,0,0,0,0,0,0,0,0,0,0,0,0,0,0,0,0,0,0,0,0,0,0,0,0,0,0,25,26,26,28,29,29,29,29,30,15,0,0,0,0,0,0,0,0,0,0,0,0,34,0,0,0,116,118,0,0,0,0,34,0,0,0,0,34,0,0,0,0,0,0,0,
0,0,0,0,0,0,0,0,0,0,0,0,0,0,0,0,0,0,7,9,0,0,0,0,0,0,0,0,0,0,0,0,0,0,0,0,0,0,0,0,0,0,0,0,0,0,0,0,0,0,0,0,0,0,25,26,26,26,26,26,27,0,0,0,0,0,0,0,34,0,0,0,0,0,0,0,0,7,9,0,0,0,0,0,0,0,0,0,0,0,0,0,0,0,0,0,
0,0,0,0,0,0,0,0,0,0,0,0,0,0,0,0,0,0,0,0,0,0,0,0,0,0,0,0,0,0,0,0,0,0,0,0,0,0,0,0,0,0,0,0,0,0,0,0,0,0,0,0,0,0,0,0,0,0,0,0,0,0,0,0,0,0,0,0,34,0,0,0,0,118,0,0,0,0,0,0,0,0,0,118,0,0,0,116,118,0,0,0,0,0,46,0,
0,0,0,0,0,0,0,0,0,0,0,0,0,0,0,0,0,0,0,0,0,0,34,34,34,34,34,0,0,0,0,0,0,0,0,0,0,0,0,0,0,0,0,0,0,0,0,0,0,0,0,0,0,0,0,0,0,0,0,0,0,0,0,0,0,0,0,0,0,0,0,0,7,9,0,0,0,0,0,0,0,0,7,9,0,0,0,7,9,0,0,0,0,0,0,0,
0,0,0,0,0,0,0,0,0,0,0,34,34,0,0,0,7,9,0,0,0,0,0,0,0,0,0,0,0,0,0,0,0,0,0,0,0,0,0,0,0,0,0,0,0,0,0,0,0,0,22,0,0,32,32,32,32,32,32,32,32,0,0,0,0,0,0,102,103,0,0,0,0,0,0,0,0,0,0,0,0,0,0,0,0,0,0,0,0,0,0,0,0,117,117,0,
0,0,0,0,0,0,0,0,0,0,0,0,0,0,0,0,0,0,0,0,0,0,0,102,103,117,118,0,0,0,0,0,0,0,0,0,0,0,0,0,0,0,0,0,0,0,0,0,116,1,2,2,2,2,2,2,2,2,2,2,2,3,85,118,118,0,0,7,9,0,0,0,0,0,0,0,0,0,0,0,0,0,0,0,0,0,0,0,0,0,0,116,1,2,2,2,
0,0,0,0,0,0,0,0,0,0,116,116,117,0,0,0,0,0,0,0,0,1,2,2,2,2,2,3,0,0,0,0,0,0,0,0,0,0,0,0,0,0,0,0,0,0,0,116,1,14,14,14,14,14,14,14,14,14,4,5,4,5,2,2,3,0,0,0,0,0,0,0,0,0,0,0,0,0,0,0,0,0,0,0,0,0,0,0,0,0,0,1,4,5,5,5,
0,0,116,117,117,117,0,102,103,0,1,2,2,3,0,116,22,116,117,85,22,13,4,5,5,5,6,15,0,116,117,117,117,117,0,0,0,0,0,0,0,0,0,117,102,103,116,1,14,4,5,5,5,5,5,5,6,5,17,17,5,17,5,5,6,0,0,0,0,0,0,0,0,0,0,0,0,0,0,0,0,0,0,0,0,0,0,0,0,0,0,13,16,17,17,17,
2,2,2,2,2,2,2,2,2,2,4,5,5,6,2,2,2,2,2,2,2,14,16,17,17,17,18,14,2,2,2,2,2,2,3,19,20,20,20,20,20,21,1,2,2,2,2,14,4,17,17,17,17,17,17,29,30,29,17,17,17,17,17,17,18,10,10,10,10,10,10,10,10,10,10,10,10,10,10,10,10,10,10,10,10,10,10,10,10,10,10,13,16,17,17,17,
5,5,5,5,5,5,5,5,5,5,17,17,17,17,5,5,5,5,5,5,5,5,17,17,17,17,17,6,14,4,5,5,5,6,15,0,0,0,0,0,0,0,13,14,14,4,5,5,17,17,17,17,17,17,18,14,14,14,16,17,17,17,17,17,17,6,14,14,14,14,14,4,5,5,5,5,5,5,5,5,5,5,5,5,5,5,5,5,5,5,5,4,17,17,17,17,
17,17,17,17,17,17,17,17,17,17,17,17,17,17,17,17,17,17,17,17,17,17,17,17,17,17,17,17,5,17,17,17,17,18,15,0,0,0,0,0,0,0,13,4,5,17,17,17,17,17,17,17,17,17,17,5,5,5,17,17,17,17,17,17,17,17,5,5,5,5,5,17,17,17,17,17,17,17,17,17,17,17,17,17,17,17,17,17,17,17,17,17,17,17,17,17</data>
    </layer>
    <layer id="back">
      <data>0,0,0,0,0,0,0,0,0,0,0,0,0,0,0,0,0,0,0,0,0,0,0,0,0,0,0,0,0,0,0,162,0,0,0,0,0,0,0,0,0,160,161,0,0,0,0,0,0,0,0,0,0,0,0,0,0,0,0,0,0,0,0,0,0,0,0,0,0,0,0,0,0,0,0,0,0,0,0,0,0,0,0,0,0,0,0,0,0,0,0,0,0,0,0,0,
0,0,0,0,0,0,0,0,0,0,0,0,0,0,0,0,0,0,0,0,0,0,0,0,0,0,0,0,0,0,161,162,0,0,0,0,0,0,0,0,0,160,161,0,0,0,0,0,0,0,0,0,0,0,0,0,0,0,0,0,0,0,0,0,0,0,0,0,0,0,0,0,0,0,0,161,161,161,161,161,161,161,161,161,161,161,161,161,0,0,0,0,0,0,0,0,
0,172,153,161,0,0,0,0,0,0,0,0,0,0,0,0,0,0,0,0,0,0,0,0,0,0,0,161,161,161,161,162,0,0,0,0,0,0,0,0,0,160,161,161,0,0,0,0,0,0,0,0,0,0,0,0,0,0,0,0,0,0,0,0,161,161,161,161,161,161,161,161,161,161,161,161,161,161,161,161,161,161,161,161,161,161,161,161,161,161,161,161,161,161,161,0,
0,0,172,153,161,0,0,0,0,0,0,0,0,0,0,0,0,0,0,0,0,0,0,0,0,0,161,161,161,161,161,175,150,0,0,0,0,0,0,0,0,172,161,161,161,161,0,0,0,0,0,0,0,0,0,0,0,0,0,0,0,0,161,161,161,161,161,161,161,161,161,151,152,152,153,161,161,161,161,151,152,152,153,161,161,161,161,161,161,161,161,161,161,161,161,0,
0,0,0,160,161,161,162,0,0,0,160,162,0,0,0,0,0,0,0,0,0,0,0,0,160,161,161,151,152,152,153,161,162,0,0,0,0,0,0,0,0,0,160,161,161,161,161,0,0,0,0,0,0,0,0,0,0,0,0,0,0,161,161,161,161,161,161,161,161,151,152,174,0,0,160,161,161,161,161,162,0,0,160,161,161,161,161,161,161,161,161,161,161,161,161,0,
0,0,0,172,153,161,162,0,0,0,160,175,150,0,0,0,0,0,0,0,0,0,0,0,160,161,151,171,0,0,160,161,162,0,0,0,0,0,0,0,0,0,160,161,161,161,161,161,0,0,0,0,0,0,0,0,0,0,0,0,0,161,161,161,161,161,161,151,152,174,0,0,0,0,172,153,161,161,161,174,0,0,160,161,161,151,152,152,153,161,161,161,161,161,161,0,
0,0,0,0,160,161,175,150,0,0,160,161,162,0,0,0,0,0,0,0,0,0,0,0,160,161,162,0,0,0,160,161,175,150,0,0,0,0,0,0,0,0,172,161,161,161,161,161,161,161,0,0,0,0,0,0,0,0,0,0,0,161,161,161,161,161,161,162,0,0,0,0,0,0,0,160,161,161,162,0,0,0,160,161,161,162,0,0,172,153,161,161,161,161,0,0,
0,0,0,0,160,161,161,162,0,0,160,161,162,0,0,0,0,0,0,0,0,0,0,148,177,161,162,0,0,0,160,161,161,162,0,0,0,0,0,0,0,0,0,160,161,161,161,161,161,161,161,161,0,0,0,0,0,0,0,0,0,161,161,161,161,161,161,162,0,0,0,0,0,0,148,177,161,161,175,150,0,148,177,161,161,162,0,0,0,172,153,161,161,161,161,161,
0,0,0,148,177,161,161,162,0,0,160,161,162,0,0,0,0,0,0,0,0,0,0,160,161,161,162,0,0,0,172,153,161,162,0,0,0,0,0,0,0,0,0,160,161,161,161,161,151,161,161,161,161,161,161,0,0,0,0,0,161,161,161,161,161,161,151,171,0,0,0,0,0,0,160,161,161,161,161,175,176,177,161,161,161,175,176,150,0,0,160,161,161,161,161,161,
0,0,148,177,161,161,161,175,150,0,160,161,175,150,0,0,0,0,0,0,0,0,0,160,151,152,175,150,0,0,0,160,161,162,0,0,0,0,0,0,0,0,0,172,161,161,161,161,163,172,153,161,161,161,161,161,151,152,152,152,152,153,161,161,161,161,162,0,0,0,0,0,148,149,177,161,161,161,161,161,161,161,161,161,161,161,161,162,0,0,172,153,161,161,161,161,
0,0,160,161,161,151,173,173,161,149,177,161,161,162,0,0,0,0,0,0,0,0,148,177,174,0,160,163,0,0,0,160,161,175,150,0,0,0,0,0,0,0,0,0,160,161,161,152,174,0,165,161,161,161,161,161,162,0,0,0,0,172,173,173,153,161,162,0,0,0,148,176,177,161,161,161,161,161,161,161,161,161,161,161,161,161,161,175,150,0,0,160,161,161,161,161,
0,148,177,161,161,162,0,0,172,153,161,161,161,175,150,0,0,0,0,0,0,148,177,162,0,0,160,163,0,148,149,177,161,161,162,0,0,0,0,0,0,0,0,148,177,151,174,0,0,148,177,161,161,161,161,161,175,149,149,150,0,0,0,0,172,153,162,0,0,148,177,161,161,161,161,161,151,152,152,152,153,161,161,161,161,161,161,161,175,176,176,177,161,161,161,161,
148,177,161,151,173,174,0,0,0,160,161,161,161,161,162,0,0,0,0,0,148,177,161,162,148,149,177,175,149,177,161,161,161,161,162,0,0,0,0,0,0,0,148,177,161,163,0,148,176,161,0,0,0,0,0,0,0,0,0,0,0,161,150,0,0,172,153,176,176,177,161,161,161,161,151,152,174,0,0,0,172,152,152,152,152,153,161,161,161,161,161,161,161,0,0,0,
177,161,161,162,0,0,0,0,148,177,161,161,161,161,175,149,149,150,0,148,177,161,0,0,0,0,0,161,161,161,161,161,161,161,175,150,0,0,0,0,0,148,177,161,161,175,149,161,161,0,0,0,0,0,0,0,0,0,0,0,0,0,0,0,150,0,160,161,161,161,161,161,161,151,174,0,0,0,0,0,0,0,0,0,0,160,161,161,161,161,161,161,0,0,0,0,
161,161,161,162,0,0,0,0,160,161,161,0,0,161,161,161,161,175,149,177,161,0,0,0,0,0,0,0,161,161,161,161,161,161,161,162,0,0,0,0,148,177,161,161,161,161,161,161,0,0,0,0,0,0,0,0,0,0,0,0,0,0,0,0,0,149,177,161,161,161,161,161,161,175,176,150,0,0,0,0,0,0,0,148,176,177,161,161,161,161,161,0,0,0,0,0,
0,0,0,0,0,0,0,0,0,0,0,0,0,0,0,0,0,0,0,0,0,0,0,0,0,0,0,0,0,0,0,0,0,0,161,162,0,0,0,0,160,161,161,0,0,0,0,0,0,0,0,0,0,0,0,0,0,0,0,0,0,0,0,0,0,161,161,161,161,161,161,161,161,161,161,174,0,0,0,0,0,0,148,161,161,161,161,161,161,161,161,0,0,0,0,0,
0,0,0,0,0,0,0,0,0,0,0,0,0,0,0,0,0,0,0,0,0,0,0,0,0,0,0,0,0,0,0,0,0,0,0,162,0,0,0,0,172,161,0,0,0,0,0,0,0,0,0,0,0,0,0,0,0,0,0,0,0,0,0,0,0,0,0,0,0,0,0,0,0,0,0,0,0,0,0,0,0,0,0,0,0,0,0,0,0,0,0,0,0,0,0,0,
0,0,0,0,0,0,0,0,0,0,0,0,0,0,0,0,0,0,0,0,0,0,0,0,0,0,0,0,0,0,0,0,0,0,0,162,0,0,0,0,0,172,0,0,0,0,0,0,0,0,0,0,0,0,0,0,0,0,0,0,0,0,0,0,0,0,0,0,0,0,0,0,0,0,0,0,0,0,0,0,0,0,0,0,0,0,0,0,0,0,0,0,0,0,0,0</data>
    </layer>
    <layer id="deco">
      <data>0,0,0,0,0,0,0,0,0,0,0,0,0,0,0,0,0,0,0,0,0,0,0,0,0,0,0,0,0,0,0,0,0,0,0,0,0,0,0,0,0,0,0,0,0,0,0,0,0,0,0,0,0,0,0,0,0,0,0,0,0,0,0,0,0,0,0,0,0,0,0,0,0,0,0,0,0,0,0,0,0,0,0,0,0,0,0,0,0,0,0,0,0,0,0,0,
0,0,0,0,0,0,0,0,0,0,0,0,0,0,0,0,0,0,0,0,0,0,0,0,0,0,0,0,0,0,0,0,0,0,0,0,0,0,0,0,0,0,0,0,0,0,0,0,0,0,0,0,0,0,0,0,0,0,0,0,0,0,0,0,0,0,0,0,0,0,0,0,0,0,0,0,0,0,0,0,0,0,0,0,0,0,0,0,0,0,14,0,17,17,17,0,
0,0,0,0,0,0,0,0,0,0,0,0,0,0,0,0,0,0,0,0,0,0,0,0,0,0,0,0,0,0,0,0,0,0,0,0,0,0,0,0,0,0,0,0,0,0,0,0,0,0,0,0,0,0,0,0,0,0,0,0,0,0,0,0,0,0,0,0,0,0,0,0,0,0,0,0,0,0,0,0,0,0,0,0,0,0,0,0,0,0,13,4,17,17,17,17,
0,0,0,0,0,0,0,0,0,0,0,0,0,0,0,0,0,0,0,0,0,0,0,0,0,0,0,0,0,0,0,0,0,0,0,0,0,0,0,0,0,0,0,0,0,0,0,0,0,0,0,0,0,0,0,0,0,0,0,0,0,0,0,0,0,0,0,0,0,0,0,0,0,0,0,0,0,0,0,0,0,0,0,0,0,0,0,0,0,0,13,16,17,17,17,17,
0,0,0,0,0,0,0,0,0,0,0,0,0,0,0,0,0,0,0,0,0,0,0,0,0,0,0,0,0,0,0,0,0,0,0,0,0,0,0,0,0,0,0,0,0,0,0,0,0,0,0,0,0,0,0,0,0,0,0,0,0,0,0,0,0,0,0,0,0,0,0,0,0,0,0,0,0,0,0,0,0,0,0,0,0,0,0,0,0,0,13,16,17,17,17,17,
0,0,0,0,0,0,0,0,0,0,0,0,0,0,0,0,0,0,0,0,0,0,0,0,0,0,0,0,0,0,0,0,0,0,0,0,0,0,0,0,0,0,0,0,0,0,0,0,0,0,0,0,0,0,0,0,0,0,0,0,0,0,0,0,0,0,0,0,0,0,0,0,0,0,0,0,0,0,0,0,0,0,0,0,0,0,0,0,0,0,13,28,29,29,29,29,
0,0,0,0,0,0,0,0,0,0,0,0,0,0,0,0,0,0,0,0,0,0,0,0,0,0,0,0,0,0,0,0,0,0,0,0,0,0,0,0,0,0,0,0,0,0,0,0,0,0,0,0,0,0,0,0,0,0,0,0,0,0,0,0,0,0,0,0,0,0,0,0,0,0,0,0,0,0,0,0,0,0,0,0,0,0,0,0,0,0,0,0,0,0,0,0,
0,0,0,0,0,0,0,0,0,0,0,0,0,0,0,0,0,0,0,0,0,0,0,0,0,0,0,0,0,0,0,0,0,0,0,0,0,0,0,0,0,0,0,0,0,0,0,0,0,0,0,0,0,0,0,0,0,0,0,0,0,0,0,0,0,0,0,0,0,0,0,0,0,0,0,0,0,0,0,0,0,0,0,0,0,0,0,0,0,0,0,0,0,0,0,0,
0,0,0,0,0,0,0,0,0,0,0,0,0,0,0,0,0,0,0,0,0,0,0,0,0,0,0,0,0,0,0,0,0,0,0,0,0,0,0,0,0,0,0,0,0,0,0,0,0,0,0,0,0,0,0,0,0,0,0,0,0,0,0,0,0,0,0,0,0,0,0,0,0,0,0,0,0,0,0,0,0,0,0,0,0,0,0,0,0,0,0,0,0,0,0,0,
0,0,0,0,0,0,0,0,0,0,0,0,0,0,0,0,0,0,0,0,0,0,0,0,0,0,0,0,0,0,0,0,0,0,0,0,0,0,0,0,0,0,0,0,0,0,0,0,0,0,0,0,0,0,0,0,0,0,0,0,0,0,0,0,0,0,0,0,0,0,0,0,0,0,0,0,0,0,0,0,0,0,0,0,0,0,0,0,0,0,0,0,0,0,0,0,
0,0,0,0,0,0,0,0,0,0,0,0,0,0,0,0,0,0,0,0,0,0,0,0,0,0,0,0,0,0,0,0,0,0,0,0,0,0,0,0,0,0,0,0,0,0,0,0,0,0,0,0,0,0,0,0,0,0,0,0,0,0,0,0,0,0,0,0,0,0,0,0,0,0,0,0,0,0,0,0,0,0,0,0,0,0,0,0,0,0,0,0,0,0,0,0,
0,0,0,0,0,0,0,0,0,0,0,0,0,0,0,0,0,0,0,0,0,0,0,0,0,0,0,0,0,0,0,0,0,0,0,0,0,0,0,0,0,0,0,0,0,0,0,0,0,0,0,0,0,0,0,0,0,0,0,0,0,0,0,0,0,0,0,0,0,0,0,0,0,0,0,0,0,0,0,0,0,0,0,0,0,0,0,0,0,0,0,0,0,0,0,0,
0,0,0,0,0,0,0,0,0,0,0,0,0,0,0,0,0,0,0,0,0,0,0,0,0,0,0,0,0,0,0,0,0,0,0,0,0,0,0,0,0,0,0,0,0,0,0,0,0,0,0,0,0,0,0,0,0,0,0,0,0,0,0,0,0,0,0,0,0,0,0,0,0,0,0,0,0,0,0,0,0,0,0,0,0,0,0,0,0,0,0,0,0,0,0,0,
0,0,0,0,0,0,0,0,0,0,0,0,0,0,0,0,0,0,0,0,0,0,0,0,0,0,0,0,0,0,0,0,0,0,0,0,0,0,0,0,0,0,0,0,0,0,0,0,0,0,0,0,0,0,0,0,0,0,0,0,0,0,0,0,0,0,0,0,0,0,0,0,0,0,0,0,0,0,0,0,0,0,0,0,0,0,0,0,0,0,0,0,0,0,0,0,
0,0,0,0,0,0,0,0,0,0,0,0,0,0,0,0,0,0,0,0,0,0,0,0,0,0,0,0,0,0,0,0,0,0,0,0,0,0,0,0,0,0,0,0,0,0,0,0,0,0,0,0,0,0,0,0,0,0,0,0,0,0,0,0,0,0,0,0,0,0,0,0,0,0,0,0,0,0,0,0,0,0,0,0,0,0,0,0,0,0,0,0,0,0,0,0,
0,0,0,0,0,0,0,0,0,0,0,0,0,0,0,0,0,0,0,0,0,0,0,0,0,0,0,0,0,0,0,0,0,0,0,0,0,0,0,0,0,0,0,0,0,0,0,0,0,0,0,0,0,0,0,0,0,0,0,0,0,0,0,0,0,0,0,0,0,0,0,0,0,0,0,0,0,0,0,0,0,0,0,0,0,0,0,0,0,0,0,0,0,0,0,0,
0,0,0,0,0,0,0,0,0,0,0,0,0,0,0,0,0,0,0,0,0,0,0,0,0,0,0,0,0,0,0,0,0,0,0,0,0,0,0,0,0,0,0,0,0,0,0,0,0,0,0,0,0,0,0,0,0,0,0,0,0,0,0,0,0,0,0,0,0,0,0,0,0,0,0,0,0,0,0,0,0,0,0,0,0,0,0,0,0,0,0,0,0,0,0,0,
0,0,0,0,0,0,0,0,0,0,0,0,0,0,0,0,0,0,0,0,0,0,0,0,0,0,0,0,0,0,0,0,0,0,0,0,0,0,0,0,0,0,0,0,0,0,0,0,0,0,0,0,0,0,0,0,0,0,0,0,0,0,0,0,0,0,0,0,0,0,0,0,0,0,0,0,0,0,0,0,0,0,0,0,0,0,0,0,0,0,0,0,0,0,0,0</data>
    </layer>
  </room>
</level>
