<?xml version="1.0" encoding="UTF-8"?>
<level>
	<room backgroundId="10011" size="0" saveOnEntrance="1" playerPosX="100" playerPosY="300">
		<layer id="base">
			<data>0,0,0,0,0,0,0,0,0,0,0,0,0,0,0,265,266,268,269,257,257,257,257,257,257,257,257,257,257,257,257,257,
0,0,0,0,0,0,0,0,0,0,0,0,0,0,0,263,0,265,266,268,269,257,257,257,257,257,257,257,257,257,257,257,
0,0,0,0,0,0,0,0,0,0,0,0,0,0,0,0,0,0,0,265,254,268,257,257,257,257,257,257,257,257,257,257,
0,0,0,0,0,0,0,0,0,0,0,0,0,0,0,0,0,0,0,263,253,254,268,257,257,257,257,257,257,257,257,257,
0,0,0,0,0,0,0,0,0,0,0,0,0,0,0,0,0,0,0,0,265,266,254,257,257,257,257,257,257,257,257,257,
0,0,0,0,0,0,0,0,0,0,0,0,0,0,0,0,0,0,0,0,0,251,253,268,257,257,257,257,257,257,257,257,
0,0,0,0,0,0,0,0,0,0,0,0,0,0,0,0,0,0,0,0,0,263,265,254,256,257,257,257,257,257,257,257,
0,0,0,0,0,0,0,0,0,0,0,0,0,0,0,0,0,0,0,0,0,0,275,253,256,257,257,257,257,257,257,257,
0,0,0,0,0,0,0,0,0,0,0,0,0,0,0,0,0,0,0,0,0,0,222,253,256,257,257,257,257,257,257,257,
0,0,0,0,0,0,0,0,0,0,0,0,0,0,0,0,0,0,0,0,0,0,253,253,268,257,257,257,257,257,257,257,
0,0,0,0,0,0,0,0,0,0,0,0,0,0,0,0,0,0,0,0,0,0,265,266,254,256,257,257,257,257,257,257,
0,0,0,0,0,0,0,0,0,0,0,0,0,0,0,34,34,34,0,0,0,0,0,251,253,256,257,257,257,257,257,257,
0,0,0,0,0,0,0,0,0,0,0,0,0,0,0,34,34,34,0,0,0,0,0,263,253,256,257,257,257,257,257,257,
0,250,0,0,0,0,0,250,0,0,0,0,0,0,0,34,34,34,0,0,0,0,0,0,253,256,257,257,257,257,257,257,
0,262,0,275,0,0,0,262,0,0,0,0,0,0,0,0,34,0,0,0,0,0,275,222,254,256,257,257,257,257,257,257,
223,223,223,223,223,254,254,254,224,250,0,0,0,0,0,0,0,0,0,0,250,0,222,254,244,257,257,257,257,257,257,257,
245,245,245,245,245,245,245,246,254,254,224,0,0,0,0,0,0,0,0,0,262,222,254,244,257,257,257,257,257,257,257,257,
257,257,257,257,257,257,257,257,245,245,245,254,224,0,0,0,0,0,0,0,222,254,244,257,257,257,257,257,257,257,257,257</data>
		</layer>
		<layer id="back">
			<data>0,0,0,0,0,0,0,0,0,0,0,304,285,293,293,293,293,293,293,293,293,293,293,293,293,293,293,293,293,293,293,293,
0,0,0,0,0,0,0,0,0,0,0,0,292,293,293,293,293,293,293,293,293,293,293,293,293,293,293,293,293,293,293,293,
0,0,0,0,0,0,0,0,0,0,0,0,292,293,293,293,293,293,293,293,293,293,293,293,293,293,293,293,293,293,293,293,
0,0,0,0,0,0,0,0,0,0,0,0,292,293,293,293,293,293,293,293,293,293,293,293,293,293,293,293,293,293,293,293,
0,0,0,0,0,0,0,0,0,0,0,0,304,285,293,293,293,293,293,293,293,293,293,293,293,293,293,293,293,293,293,293,
0,0,0,0,0,0,0,0,0,0,0,0,280,309,293,293,293,293,293,293,293,293,293,293,293,293,293,293,293,293,293,293,
0,0,0,0,0,0,0,0,0,0,280,281,309,293,293,293,293,293,293,293,293,293,293,293,293,293,293,293,293,293,293,293,
0,0,0,0,0,0,0,0,0,0,292,293,293,293,293,293,293,293,311,311,293,293,293,293,293,293,293,293,293,293,293,293,
0,0,0,0,0,0,0,0,0,280,309,293,293,293,293,293,311,311,290,287,293,293,293,293,293,293,293,293,293,293,293,293,
281,281,282,0,0,0,0,0,280,309,293,293,293,293,300,311,290,290,290,293,293,293,293,293,293,293,293,293,293,293,293,293,
293,293,307,281,281,281,281,281,309,293,293,293,293,300,290,290,290,287,293,293,293,293,293,293,293,293,293,293,293,293,293,293,
293,293,293,293,293,293,293,293,293,293,293,293,293,293,290,287,293,293,293,293,293,293,293,293,293,293,293,293,293,293,293,293,
293,293,293,293,293,293,293,293,293,293,293,293,293,293,293,293,293,293,293,293,293,293,293,293,293,293,293,293,293,293,293,293,
293,293,293,293,293,293,293,293,293,293,293,293,293,293,312,287,293,293,293,293,293,293,293,293,293,293,293,293,293,293,293,293,
293,293,293,293,293,293,293,293,293,293,293,293,293,293,300,310,293,293,293,293,293,293,293,293,293,293,293,293,293,293,293,293,
293,293,293,293,293,293,293,293,293,293,293,293,293,293,293,293,293,293,293,293,293,293,293,293,293,293,293,293,293,293,293,293,
293,293,293,293,293,293,293,293,293,293,293,293,293,293,293,293,293,293,293,293,293,293,293,293,293,293,293,293,293,293,293,293,
293,293,293,293,293,293,293,293,293,293,293,293,293,293,293,293,293,293,293,293,293,293,293,293,293,293,293,293,293,293,293,293</data>
		</layer>
		<layer id="deco">
			<data>0,0,0,0,0,0,0,0,0,0,0,0,0,0,0,0,0,0,0,0,0,0,0,0,0,0,0,0,0,0,0,0,
0,0,0,0,0,0,0,0,0,0,0,0,0,0,0,0,0,0,0,0,0,0,0,0,0,0,0,0,0,0,0,0,
0,0,0,0,0,0,0,0,0,0,0,0,0,0,0,0,0,0,0,0,0,0,0,0,0,0,0,0,0,0,0,0,
0,0,0,0,0,0,0,0,0,0,0,0,0,0,0,0,0,0,0,0,0,0,0,0,0,0,0,0,0,0,0,0,
0,0,0,0,0,0,0,0,0,0,0,0,0,0,0,0,0,0,0,0,0,0,0,0,0,0,0,0,0,0,0,0,
0,0,0,0,0,0,0,0,0,0,0,0,0,0,0,0,0,0,0,0,0,0,0,0,0,0,0,0,0,0,0,0,
0,0,0,0,0,0,0,0,0,0,0,0,0,0,0,0,0,0,0,0,0,0,0,0,0,0,0,0,0,0,0,0,
0,0,0,0,0,0,0,0,0,0,0,0,0,0,0,0,0,0,0,0,0,0,0,0,0,0,0,0,0,0,0,0,
0,0,0,0,0,0,0,0,0,0,0,0,0,0,0,0,0,0,0,0,0,0,0,0,0,0,0,0,0,0,0,0,
0,0,0,0,0,0,0,0,0,0,0,0,0,0,0,0,0,0,0,0,0,0,0,0,0,0,0,0,0,0,0,0,
0,0,0,0,0,0,0,0,0,0,0,0,0,0,0,0,0,0,0,0,0,0,0,0,0,0,0,0,0,0,0,0,
0,0,0,0,0,0,0,0,0,0,0,0,0,0,0,0,0,0,0,0,0,0,0,0,0,0,0,0,0,0,0,0,
0,0,0,0,0,0,0,0,0,0,0,0,0,0,0,0,0,0,0,0,0,0,0,0,0,0,0,0,0,0,0,0,
0,0,0,0,0,0,0,0,0,0,0,0,0,0,0,0,0,0,0,0,0,0,0,0,0,0,0,0,0,0,0,0,
0,0,0,0,0,0,0,0,0,0,0,0,0,0,0,0,0,0,0,0,0,0,0,0,0,0,0,0,0,0,0,0,
0,0,0,0,0,0,0,0,0,0,0,0,0,0,0,0,0,0,0,0,0,0,0,0,0,0,0,0,0,0,0,0,
0,0,0,0,0,0,0,0,0,0,0,0,0,0,0,0,0,0,0,0,0,0,0,0,0,0,0,0,0,0,0,0,
0,0,0,0,0,0,0,0,0,0,0,0,0,0,0,0,0,0,0,0,0,0,0,0,0,0,0,0,0,0,0,0</data>
		</layer>
		<layer id="functional">
			<data>0,0,0,0,0,0,0,0,0,0,0,0,0,0,0,0,0,0,0,0,0,0,0,0,0,0,0,0,0,0,0,0,
0,0,0,0,0,0,0,0,0,0,0,0,0,0,0,0,0,0,0,0,0,0,0,0,0,0,0,0,0,0,0,0,
0,0,0,0,0,0,0,0,0,0,0,0,0,0,0,0,0,0,0,0,0,0,0,0,0,0,0,0,0,0,0,0,
0,0,0,0,0,0,0,0,0,0,0,0,0,0,0,0,0,0,0,0,0,0,0,0,0,0,0,0,0,0,0,0,
0,0,0,0,0,0,0,0,0,0,0,0,0,0,0,0,0,0,0,0,0,0,0,0,0,0,0,0,0,0,0,0,
0,0,0,0,0,0,0,0,0,0,0,0,0,0,0,0,0,0,0,0,0,0,0,0,0,0,0,0,0,0,0,0,
0,0,0,0,0,0,0,0,0,0,0,0,0,0,0,0,0,0,0,0,0,0,0,0,0,0,0,0,0,0,0,0,
0,0,0,0,0,0,0,0,0,0,0,0,0,0,0,0,0,0,0,0,0,0,0,0,0,0,0,0,0,0,0,0,
0,0,0,0,0,0,0,0,0,0,0,0,0,0,0,0,0,0,0,0,0,0,0,0,0,0,0,0,0,0,0,0,
0,0,0,0,0,0,0,0,0,0,0,0,0,0,0,0,0,0,0,0,0,0,0,0,0,0,0,0,0,0,0,0,
0,0,0,0,0,0,0,0,0,0,0,0,0,0,0,0,0,0,0,0,0,0,0,0,0,0,0,0,0,0,0,0,
0,0,0,0,0,0,0,0,0,0,0,0,0,0,0,0,0,0,0,0,0,0,0,0,0,0,0,0,0,0,0,0,
0,0,0,0,0,0,0,0,0,0,0,0,0,0,0,0,0,0,0,0,0,0,0,0,0,0,0,0,0,0,0,0,
0,0,0,0,0,0,0,0,0,0,0,0,0,0,0,0,0,0,0,0,0,0,0,0,0,0,0,0,0,0,0,0,
0,0,0,0,0,0,0,0,0,0,0,0,0,0,0,0,0,0,0,0,0,0,0,0,0,0,0,0,0,0,0,0,
0,0,0,0,0,0,0,0,0,0,0,0,0,0,0,0,0,0,0,0,0,0,0,0,0,0,0,0,0,0,0,0,
0,0,0,0,0,0,0,0,0,0,0,0,0,0,0,0,0,0,0,0,0,0,0,0,0,0,0,0,0,0,0,0,
0,0,0,0,0,0,0,0,0,0,0,0,0,238,238,238,238,238,238,238,0,0,0,0,0,0,0,0,0,0,0,0</data>
		</layer>
	</room>
	<exits>
		<exit levelId="3" roomId="1" x="13" y="17"></exit>
		<exit levelId="3" roomId="1" x="14" y="17"></exit>
		<exit levelId="3" roomId="1" x="15" y="17"></exit>
		<exit levelId="3" roomId="1" x="16" y="17"></exit>
		<exit levelId="3" roomId="1" x="17" y="17"></exit>
		<exit levelId="3" roomId="1" x="18" y="17"></exit>
		<exit levelId="3" roomId="1" x="19" y="17"></exit>
	</exits>
</level>
